0000000000000030000000000000000000000000000000000000000000000000000000000000000000000000000000000000000000000000000000000300000000000000
0000000000000030000000000000000000000000000000000000000000000000000000000000000000000000000000000000000000000000000000000300000000000000
0000000000000030000000000000000000000000000000000000000000000000000000000000000000000000000000000000000000000000000000000300000000000000
0000000000000030000000000000000000000000000000000000000000000000000000000000000000000000000000000000000000000000000000000300000000000000
0000000000000030000000000000000000000000000000000000000000000000000000000000000000000000000000000000000000000000000000000300000000000000
0000000000000030000000000000000000000000000000000000000000000000000000000000000000000000000000000000000000000000000000000300000000000000
0000000000000030000000000000000000000000000000000000000000000000000000000000000000000000000000000000000000000000000000000300000000000000
0000000000000030000000000000000000000000000000000000000000000000000000000000000000000000000000000000000000000000000000000300000000000000
0000000000000030000000000000000000000000000000000000000000000000000000000000000000000000000000000000000000000000000000000300000000000000
0000000000000030000000000000000000000000000000000000000000000000000000000000000000000000000000000000000000000000000000000300000000000000
0000000000000030000000000000000000000000000000000000000110000111000000111000000000000000000000000000000000000000000000000300000000000000
0000000000000030000000000000000000010000000000000000011001101000110001000110000001110000000000000000000000000000000000000300000000000000
000000000000003000000000000000000112110000A000000011120000010000001111100001111110001111100000000000000000000000000000000300000000000000
0000000000000030000001111111111112222211111111111122221111111111112222211112222221112222211111111111111000000000000000000300000000000000
0000000000000031111112222222222222222222222222222222222222222222222222222222222222222222222222222222222111111111111111111300000000000000
0000000000000000000000000000000000000000000000000000000000000000000000000000000000000000000000000000000000000000000000000000000000000000
0000000000000000000000000000000000000000000000000000000000000000000000000000000000000000000000000000000000000000000000000000000000000000
0000000000000000000000000000000000000000000000000000000000000000000000000000000000000000000000000000000000000000000000000000000000000000
0000000000000000000000000000000000000000000000000000000000000000000000000000000000000000000000000000000000000000000000000000000000000000
0000000000000000000000000000000000000000000000000000000000000000000000000000000000000000000000000000000000000000000000000000000000000000
0000000000000000000000000000000000000000000000000000000000000000000000000000000000000000000000000000000000000000000000000000000000000000
0000000000000000000000000000000000000000000000000000000000000000000000000000000000000000000000000000000000000000000000000000000000000000
0000000000000000000000000000000000000000000000000000000000000000000000000000000000000000000000000000000000000000000000000000000000000000
0000000000000000000000000000000000000000000000000000000000000000000000000000000000000000000000000000000000000000000000000000000000000000
