000000000000000000000000000000000000
000000000000000000000000000000000000
000100000000000000000000000000000000
000000000000000000000000000000000000
000000000000000000000000000000000000
010000000000000000000000000000000000
000000000000000000000000000000000000
000000000000000000000000000000000000
000000000000000000000000000000000000
000000000000000000000000000000000000
000000000110000000000000000000000000
000000000000000000000000000000000000
000000000000000000000000000000000000
000000000000000000000000000000000000
000000000000000000000000000000000000
000000111110000000000000000000000000
000010000000000000100000000000000000
111111111111111111111111111111111111