0000000000000000000000000000000000000000000000000000000000000000000000000000000000000000000000000000000000000000000000000000000000000000
0000000000000000000000000000000000000000000000000000000000000000000000000000000000000000000000000000000000000000000000000000000000000000
0000000000000000000000000000000000000000000000000000000000000000000000000000000000000000000000000000000000000000000000000000000000000000
0000000000000000000000000000000000000000000000000000000000000000000000000000000000000000000000000000000000000000000000000000000000000000
0000000000000000000000000000000000000000011111111111111111111111111111111111111000000000000000000000000000000000000000000000000000000000
0000000000000000000000000000000011111111111111111111111111111111111111111111111111111111111100000000000000000000000000000000000000000000
0000000000000000000001111111111111111111111111111111111111111111111111111111111111111111111111100000000000000000000000000000000000000000
0000000000000000001111111111111111111111111111111111111111111111111111111111111111111111111111111100000000000000000000000000000000000000
0000000000000000011111111111111111111111111111111111111111111111111111111111111111111111111111111111000000000000000000000000000000000000
0000000000000000111111111111111111111111222222222222222222222222222222222221111111111111111111111111110000000000000000000000000000000000
0000000000000000111111111111111111111111222222222222222222222222222222222221111111111111111111111111110000000000000000000000000000000000
0000000000000001111111111111111111111111222222222222222222222222222222222221111111111111111111111111111000000000000000000000000000000000
0000000000000001111111111111111111111111222222222222222222222222222222222221111111111111111111111111111110000000000000000000000000000000
0000000000000011111111111111111111111111222222222222222222222222222222222221111111111111111111111111111110000000000000000000000000000000
0000000000000001111111111111111111111111222222222222222222222222222222222221111111111111111111111111111110000000000000000000000000000000
0000000000000001111111111111111111111111222222222222222222222222222222222221111111111111111111111111111111000000000000000000000000000000
0000000000000000111111111111111111111111222222222222222222222222222222222221111111111111111111111111111111000000000000000000000000000000
0000000000000000111111111111111111111111222222222222222222222222222222222221111111111111111111111111111111100000000000000000000000000000
0000000000000000111111111111111111111111222222222222222222222222222222222221111111111111111111111111111111000000000000000000000000000000
0000000000000000001111111111111111111111222222222222222222222222222222222221111111111111111111111111111111000000000000000000000000000000
0000000000000000000111111111111111111111111111111111111111111111111111111111111111111111111111111111111110000000000000000000000000000000
0000000000000000000111111111111111111111111111111111111111111111111111111111111111111111111111111111111100000000000000000000000000000000
0000000000000000000111111111111111111111111111111111111111111111111111111111111111111111111111111111111100000000000000000000000000000000
0000000000000000000001111111111111111111111111111111111111111111111111111111111111111111111111111111111100000000000000000000000000000000
0000000000000000000000000000011111111111111111111111111111111111111111111111111111111111111111111111110000000000000000000000000000000000
0000000000000000000000000000000000000011111111111111111111111111111111111111111111111111111111111100000000000000000000000000000000000000
0000000000000000000000000000000000000000000000000000000000000000000000000000000000000000000000000000000000000000000000000000000000000000
0000000000000000000000000000000000000000000000000000000000000000000000000000000000000000000000000000000000000000000000000000000000000000
0000000000000000000000000000000000000000000000000000000000000000000000000000000000000000000000000000000000000000000000000000000000000000
0000000000000000000000000000000000000000000000000000000000000000000000000000000000000000000000000000000000000000000000000000000000000000
0000000000000000000000000000000000000000000000000000000000000000000000000000000000000000000000000000000000000000000000000000000000000000
0000000000000000000000000000000000000000000000000000000000000000000000000000000000000000000000000000000000000000000000000000000000000000
