000000000000000000000000000000000000000000000000000000000000000000000
000000000000000000000000000000000000000000000000000000000000000000000
000000000000000000000010000000000000000000000000000000000000000000000
000000000000001100000101000000000010000000000000000000000000000000000
000000000000011100001000100000000100000000000000000000000000000000000
000001111100111100010000010000001000000000000000000000000000000000000
111111111111111111111111111111111111111111111111111111111111111111111
